######
#X$..#
##@.$#
###.X#
######