########
##.....#
##.X$X.#
#@.$.$.#
#..X$X.#
##.....#
########