#######
#.X$..#
#.$X.@#
#..X$.#
#.###.#
#######